NO bonus/textures/s.png
SO bonus/textures/w.png
WE bonus/textures/w.png
EA bonus/textures/s.png

F 60,60,60
C 3,138,255

        1111111111111111111111111
        1101110001110000000001001
        11D1D10000D010000000000001
        1000000001100000001000001
1111111110N0010001110000000000001
100000000011001001110111111111111
11110111111111011100000010001
11110111111111011101010010001
11000000110101011100000010001
10000100000000001100000000001
10000010000000001101010010001
1100000111010101111101111000111
1111D111 1110101 101111010001
11111111 1111111 111111111111